9;9;

0; 1; 2; 3; 0; 1; 2; 3; 0;
1; 2; 3; 0; 1; 2; 3; 0; 1;
2; 3; 0; 1; 2; 3; 2; 1; 2;
3; 0; 1; 2; 3; 0; 1; 2; 3;
0; 1; 2; 3; 0; 1; 2; 3; 0;
1; 2; 3; 2; 1; 2; 2; 0; 1;
2; 3; 0; 1; 2; 3; 0; 1; 2;
3; 0; 1; 2; 3; 0; 1; 2; 3;
0; 1; 2; 3; 0; 1; 2; 3; 0

